###############
#......#......#
#.####.#.####.#
#.#..#.#.####.#
#...##-#......#
#####....####.#
#.....#....p#.#
#.##~##x##~##.#
#.............#
###.#######.###
#......#......#
#.#..#.#.####.#
#.####.#.#..#.#
#......#......#
###############
pink 1 13
blue 8 13
red 8 3
carrot 1 1 2
carrot 1 13 2
carrot 13 6 2
carrot 13 8 2
