###############
#.............#
#.##.##.##.##.#
#.....#.#p....#
#######.#######
#.....#.#.....#
#.#x###.###x#.#
#.............#
#.#.###.###.#.#
#.#...#.#...#.#
#.###.#.#.###.#
#.#.........#.#
#...###-###...#
#.#p##___##.#.#
###############
pink 6 13
blue 7 13
red 8 13
carrot 1 1 2
carrot 1 13 2
carrot 13 6 2
carrot 13 8 2
