###############
#.........###.#
#.#####.#.....#
#.......#.#####
###.#.#.#.....#
#...#.....#.#.#
#.#.###x###.#.#
#x#.........#.#
#r#$###x#####.#
#.#...........#
#.#.#######.#.#
#.#.#######.#.#
#.#.##...##.#.#
#......#......#
###############
pink 7 12 
blue 13 13
red 1 1 
carrot 1 1 2
carrot 7 1 2
carrot 2 13 2
carrot 6 13 2
