###############
#...#.........#
#.#.#.#######p#
#.............#
####~##-##~####
#....#___#...p#
##.#.##.##.##.#
#..#..#.#..#..#
##.#.##.##.#.##
#.............#
#.#.##.#.##.#.#
#p...#.#.#..#.#
#-#.##x#x##.###
#_#...........#
###############
pink 6 5
blue 7 5
red 8 5
carrot 1 13 2
carrot 13 1 2
carrot 7 3 2
