###############
#.............#
#.###########.#
#.#.........#.#
#...###p###.#.#
#.#.#.....#...#
#.#.#.#-#.#.#.#
#~#...#_#...#~#
#.#.#.###.#.#.#
#.#.#.....#...#
#...###p###.#.#
#.#.........#.#
#.###########.#
#.............#
###############
pink 1 1
blue 13 1
red 7 13
carrot 7 1 1
carrot 1 13 1
carrot 13 13 1
